111111111111111111111111111111
100000100000000000000001000001
100000101111110011111101000001
100400000000000000000000004001
100000101010000000010101000001
100000101011110011110101000001
111011101010000000010101110111
100000001000111111000100000001
100011111000001100000111110001
100000000011101101110000000001
101000100010000000010001000101
101001110010112211010011100101
1010111110001g33g1000111110101
1010011100001g33g1000011100101
101000100010111111010001000101
100000000010000000010000000001
100011111011100001110111110001
100000001000000000000100000001
111011101010000000010101110111
100000101011111111110101000001
100000101010000000010101000001
100400000000000000000000004001
100000101111110011111101000001
10000010000000p000000001000001
111111111111111111111111111111
